"","midterm","finals","report","attend","sum","grade"
"1",30,34,10,20,94,"A"
"2",33,22,7,20,82,"B"
"3",35,30,5,18,88,"B"
"4",29,19,3,17,68,"D"
"5",15,24,10,15,64,"D"
"6",17,22,10,7,56,"D"
"7",10,5,9,8,32,"D"
"8",19,13,5,3,40,"D"
"9",20,25,8,10,63,"D"
"10",28,35,3,9,75,"C"
